It is the year 4003 you are in an Electronical war between two armies. You are a troop that has been trained in the arts of electronic guns for 10 years. You have been awarded with numerous medals and honors. This has been one of the biggest wars known to the electronical race. Unfortunately even with the skill and the strategies that you have, you were captured by the opposing army and are now being held in a cell. Like any other average prisoner you think to yourself, "why would I stay here?"

The Year 4003
An Interactive Fiction by Logan Moss
Release 1 / Serial number 130228 / Inform 7 build 6G60 (I6/v6.32 lib 6/12N) SD

Cell A
A prison cell that is concealed. The walls and the floor are made of some type of concrete. On the left side of the room is my makeshift of a bed. I need to stop looking around and figure out if I can find a way to get out of this cage. There is a door to the north of the room, the door says Cell A.

>take all
Why would you want to take everything here? Haha, that would be silly.

* * *

>take wire
Taken.

>take all
(Metal wire)
You already have that.

* * *

>X WALL
Which do you mean, Wall or the walls?

* * *

>x door
A Strong high-tech looking door. Surprisingly, you can see that the lock is just an old lock, I wonder why this isn't as high tech as the rest of the building.

* * *

>x box springs
Just some ordinary box springs.

* * *

>x bed
A messy non-made bed. The bed frame is made of some box springs and some metal wire. With my tactical skills maybe I could use some of these things.

>take all
There are none at all available!

>take wire
Taken.

>bend wire
You attempt to bend the wire into something useful, however your hand slips. You get a small cut on your hand and start bleeding. It doesn't look too bad though, maybe you should try again.
Your health is: -22

* * *

>take wire
Taken.

>unlock cell a door
(with Metal wire)
That doesn't seem to fit the lock.

>unlock cell a door with metal wire
That doesn't seem to fit the lock.

>bend wire
You attempt to bend the wire into something useful, however your hand slips. You get a small cut on your hand and start bleeding. It doesn't look too bad though, maybe you should try again.
Your health is: 97

* * *

>bend wire
You attempt to bend the wire into something useful, however your hand slips. You get a small cut on your hand and start bleeding. It doesn't look too bad though, maybe you should try again.
Your health is: 95

>bend wire
You attempt to bend the wire into something useful, however your hand slips. You get a small cut on your hand and start bleeding. It doesn't look too bad though, maybe you should try again.
Your health is: 91

>bend wire
You attempt to bend the wire into something useful, however your hand slips. You get a small cut on your hand and start bleeding. It doesn't look too bad though, maybe you should try again.
Your health is: 89

>bend wire
Using your strength and rough hands, you bend the wire into a key!

>unlock door with key
You unlock Cell A door.

>n
You can't go that way.

I beg your pardon?

I beg your pardon?

>n
You can't go that way.

>w
You can't go that way.

* * *

>take wire
Taken.

>bend wire
You attempt to bend the wire into something useful, however your hand slips. You get a small cut on your hand and start bleeding. It doesn't look too bad though, maybe you should try again.
Your health is: 97

* * *

>bend wire
Using your strength and rough hands, you bend the wire into a key!

>bend wire
You attempt to bend the wire into something useful, however your hand slips. You get a small cut on your hand and start bleeding. It doesn't look too bad though, maybe you should try again.
Your health is: -6

>bend wire
Using your strength and rough hands, you bend the wire into a key!

* * *

>n
You can't go that way.

>open door
You open Cell A door.

>n
You can't go that way.

>norht
That's not a verb I recognise.

>north
You can't go that way.

* * *

>x me
Just an average trooper that has been trying to serve his duty in the line of fire. With only a couple of wounds and some electric burns in my armor, still as dashing as ever.

* * *

>x walls
Just a hard wall that is made of concrete.

* * *

>n
You can't go that way.

* * *

>x wall
Just a hard wall that is made of concrete.