It is the year 4003 you are in an Electronical war between two armies. You are a troop that has been trained in the arts of electronic guns for 10 years. You have been awarded with numerous medals and honors. This has been one of the biggest wars known to the electronical race. Unfortunately even with the skill and the strategies that you have, you were captured by the opposing army and are now being held in a cell. Like any other average prisoner you think to yourself, "why would I stay here?"

The Year 4003
An Interactive Fiction by Logan Moss
Release 1 / Serial number 130305 / Inform 7 build 6G60 (I6/v6.32 lib 6/12N) SD

Cell A
A prison cell that is concealed. The walls and the floor are made of some type of concrete. On the left side of the room is my makeshift of a bed. I need to stop looking around and figure out if I can find a way to get out of this cage. There is a door to the north of the room, the door says Cell A.

I beg your pardon?

* * *

>w
You can't go that way.

>x
What do you want to examine?

>l
Cell A
A prison cell that is concealed. The walls and the floor are made of some type of concrete. On the left side of the room is my makeshift of a bed. I need to stop looking around and figure out if I can find a way to get out of this cage. There is a door to the north of the room, the door says Cell A.

>take wire
Taken.

* * *

>bend wire
Using your strength and rough hands, you bend the wire into a key!

>open door with key
You unlock Cell A door.

>w
You can't go that way.

>e
You can't go that way.

>s
You can't go that way.

>n
You can't go that way.

* * *

>take wire
Taken.

* * *

>bend wire
You attempt to bend the wire into something useful, however your hand slips. You get a small cut on your hand and start bleeding. It doesn't look too bad though, maybe you should try again.
Your health is: 94

>bend wire
Using your strength and rough hands, you bend the wire into a key!

* * *

>open door with key
You unlock Sturdy metal door.

>w
You can't go that way.

>n
You can't go that way.

>e
You can't go that way.

* * *

>take all
Why would you want to take everything here? Haha, that would be silly.

>x bed frame
A messy non-made bed. The bed frame is made of some box springs and some metal wire. With my tactical skills maybe I could use some of these things.

>take all
There are none at all available!

>x bed
A messy non-made bed. The bed frame is made of some box springs and some metal wire. With my tactical skills maybe I could use some of these things.

* * *

>x cage
You can't see any such thing.

>x walls
Just a hard wall that is made of concrete.

>x floor
Just a hard floor that is made of concrete.

* * *

>x bed
A messy non-made bed. The bed frame is made of some box springs and some metal wire. With my tactical skills maybe I could use some of these things.

* * *

>n
hallway
A hallway that has a couple bits and pieces of wrappers and trash around. You would think in the year 4003 they would take more care of the place. There are foor door ways that lead into seperate rooms. In the west, there's a door that is labeled Storage. In the east, there's a door that has the label Cell B. In the north you can hear chatter and harsh voices and tones, probably the guard room.

>x wrapper
You can't see any such thing.

>x wrappers
Gross. It's just some sticky candy wrappers and some other dirty things.

>w
Storage
Very dusty and dark. Someone really needs to clean the cobwebs and dust off the floor and the corners.

>x cobwebs
You can't see any such thing.

>x dust
You can't see any such thing.

>x corner
You can't see any such thing.

>x corners
You can't see any such thing.

* * *

>x wall
Just a hard wall that is made of concrete.

>x walls
Which do you mean, Wall or the walls?

* * *

>x me
Just an average trooper that has been trying to serve his duty in the line of fire. With only a couple of wounds and some electric burns in my armor, still as dashing as ever.

>x
What do you want to examine?

>me
As good-looking as ever.

>x me
As good-looking as ever.

* * *

>x me
Just an average trooper that has been trying to serve his duty in the line of fire. With only a couple of wounds and some electric burns in my armor, still as dashing as ever.

>l
Cell
A prison cell that is concealed. The walls and the floor are made of some type of concrete. On the left side of the room is my makeshift of a bed. I need to stop looking around and figure out if I can find a way to get out of this cage.

* * *

>x bed
A messy non-made bed. The bed frame is made of some box springs and some metal wire. With my tactical skills maybe I could use some of these things.

>x box springs
Just some ordinary box springs.

>take box springs
I don't think I would really need that right now.

>x metal wire
Some long, hard, sturdy, and thin strips of wire. This could become very useful. With effort, I think I would be able to bend or mold this to my will.

>take metal wire
Taken.

>i
You are carrying:
  Metal wire

>bend wire
You attempt to bend the wire into something useful, however your hand slips. You get a small cut on your hand and start bleeding. It doesn't look too bad though, maybe you should try again.
Your health is: 97

>bend wire
You attempt to bend the wire into something useful, however your hand slips. You get a small cut on your hand and start bleeding. It doesn't look too bad though, maybe you should try again.
Your health is: 95

>bend wire
You attempt to bend the wire into something useful, however your hand slips. You get a small cut on your hand and start bleeding. It doesn't look too bad though, maybe you should try again.
Your health is: 92

>bend wire
You attempt to bend the wire into something useful, however your hand slips. You get a small cut on your hand and start bleeding. It doesn't look too bad though, maybe you should try again.
Your health is: 88

>bend wire
You attempt to bend the wire into something useful, however your hand slips. You get a small cut on your hand and start bleeding. It doesn't look too bad though, maybe you should try again.
Your health is: 86

>bend wire
You attempt to bend the wire into something useful, however your hand slips. You get a small cut on your hand and start bleeding. It doesn't look too bad though, maybe you should try again.
Your health is: 83

>bend wire
Using your strength and rough hands, you bend the wire into a key!

I beg your pardon?

>l
Cell A
A prison cell that is concealed. The walls and the floor are made of some type of concrete. On the left side of the room is my makeshift of a bed. I need to stop looking around and figure out if I can find a way to get out of this cage. There is a door to the north of the room, the door says Cell A.

>open door with metal key
I only understood you as far as wanting to open Sturdy metal door with Sturdy metal door.

>open door with key
You unlock Sturdy metal door.

* * *

>n
hallway
A hallway that has a couple bits and pieces of wrappers and trash around. You would think in the year 4003 they would take more care of the place. There are foor door ways that lead into seperate rooms. In the west, there's a door that is labeled Storage. In the east, there's a door that has the label Cell B. In the north you can hear chatter and harsh voices and tones, probably the guard room.

>w
Storage
Very dusty and dark. Someone really needs to clean the cobwebs and dust off the floor and the corners.

>e
hallway
A hallway that has a couple bits and pieces of wrappers and trash around. You would think in the year 4003 they would take more care of the place. There are foor door ways that lead into seperate rooms. In the west, there's a door that is labeled Storage. In the east, there's a door that has the label Cell B. In the north you can hear chatter and harsh voices and tones, probably the guard room.

>e
Cell B
A cell room that looks like it hasn't been used in over 400 years. In the corner there is a broken down bed frame. In the back of the room you spot something that has been collecting dust, it looks like a plaque. You can also see something that looks very high-tech, you can tell it wasn't installed recently, but it looks high-tech. Kind of some sort of voice application.

>x plaque
A very shiny, bright, wooden square that looks like it has been polished, but never touched. On the plaque there are some numbers, I wonder what this could be. I wonder if it's some type of riddle. Under the last number, it looks like someone scratched out the number. I wonder what that number is... It says,

1
11
21
1211
111221
312211
13112221
------

>restart
Are you sure you want to restart?

* * *

>x box springs
Just some ordinary box springs.

* * *

>bend wire
You cannot bend something that you do not have!

* * *

>bend wire
Using your strength and rough hands, you bend the wire into a key!

>open sturdy with key
You unlock Sturdy metal door.

* * *

>x walls
Just a hard wall that is made of concrete.

>x wall
Just a hard wall that is made of concrete.

* * *

>n
You can't go that way.

* * *

>X WALL
Which do you mean, Wall or the walls?

>x walls
You see nothing special about the walls.

>x wall
Which do you mean, Wall or the walls?