It is the year 4003 you are in an Electronical war between two armies. You are a troop that has been trained in the arts of electronic guns for 10 years. You have been awarded with numerous medals and honors. This has been one of the biggest wars known to the electronical race. Unfortunately even with the skill and the strategies that you have, you were captured by the opposing army and are now being held in a cell. Like any other average prisoner you think to yourself, "why would I stay here?"

The Year 4003
An Interactive Fiction by Logan Moss
Release 1 / Serial number 130306 / Inform 7 build 6G60 (I6/v6.32 lib 6/12N) SD

Cell A
A prison cell that is concealed. The walls and the floor are made of some type of concrete. On the left side of the room is my makeshift of a bed. I need to stop looking around and figure out if I can find a way to get out of this cage. There is a door to the north of the room, the door says Cell A.

I beg your pardon?

>get wire
Taken.

>bend wire
You attempt to bend the wire into something useful, however your hand slips. You get a small cut on your hand and start bleeding. It doesn't look too bad though, maybe you should try again.
Your health is: 97

>bend wire
Using your strength and rough hands, you bend the wire into a key!

* * *

>open door with key
You unlock Sturdy metal door.

>n
hallway
A hallway that has a couple bits and pieces of wrappers and trash around. You would think in the year 4003 they would take more care of the place. There are foor door ways that lead into seperate rooms. In the west, there's a door that is labeled Storage. In the east, there's a door that has the label Cell B. In the north you can hear chatter and harsh voices and tones, probably the guard room.

>e
Cell B
A cell room that looks like it hasn't been used in over 400 years. In the corner there is a broken down bed frame. In the back of the room you spot something that has been collecting dust, it looks like a plaque. You can also see something that looks very high-tech, you can tell it wasn't installed recently, but it looks high-tech. Kind of some sort of voice application.

>n
You can't go that way.

>x wall passage
You can't see any such thing.

>open wall passage
You can't see any such thing.

>1113213211
That's not a verb I recognise.

* * *

>take wire
Taken.

>bend wire
Using your strength and rough hands, you bend the wire into a key!

>open door with key
You unlock Sturdy metal door.

* * *

>e
Cell B
A cell room that looks like it hasn't been used in over 400 years. In the corner there is a broken down bed frame. In the back of the room you spot something that has been collecting dust, it looks like a plaque. You can also see something that looks very high-tech, you can tell it wasn't installed recently, but it looks high-tech. Kind of some sort of voice application.

>climb grass
You must supply a noun.

* * *

>n
hallway
A hallway that has a couple bits and pieces of wrappers and trash around. You would think in the year 4003 they would take more care of the place. There are foor door ways that lead into seperate rooms. In the west, there's a door that is labeled Storage. In the east, there's a door that has the label Cell B. In the north you can hear chatter and harsh voices and tones, probably the guard room.

>s
You can't go that way.

* * *

>open door with key
You unlock Sturdy metal door.

>open sturdy metal door
The key clicks around multiple times, luckily, the door opens. Unfortunately, your temporary key breaks.

* * *

>bend wire
Using your strength and rough hands, you bend the wire into a key!

>bend wire
You attempt to bend the wire into something useful, however your hand slips. You get a small cut on your hand and start bleeding. It doesn't look too bad though, maybe you should try again.
Your health is: 94

>bend wire
You attempt to bend the wire into something useful, however your hand slips. You get a small cut on your hand and start bleeding. It doesn't look too bad though, maybe you should try again.
Your health is: 90

>open door with key
You unlock Sturdy metal door.

* * *

>e
Cell B
A cell room that looks like it hasn't been used in over 400 years. In the corner there is a broken down bed frame. In the back of the room you spot something that has been collecting dust, it looks like a plaque. You can also see something that looks very high-tech, you can tell it wasn't installed recently, but it looks high-tech. Kind of some sort of voice application.

>x plaque
A very shiny, bright, wooden square that looks like it has been polished, but never touched. On the plaque there are some numbers, I wonder what this could be. I wonder if it's some type of riddle. It says,

1
11
21
1211
111221
312211
13112221

* * *

>bend wire
You attempt to bend the wire into something useful, however your hand slips. You get a small cut on your hand and start bleeding. It doesn't look too bad though, maybe you should try again.
Your health is: 90

>bend wire
Using your strength and rough hands, you bend the wire into a key!

* * *

>get wire
Taken.

>bend wire
Using your strength and rough hands, you bend the wire into a key!

* * *

>n
hallway
A hallway that has a couple bits and pieces of wrappers and trash around. You would think in the year 4003 they would take more care of the place. There are foor door ways that lead into seperate rooms. In the west, there's a door that is labeled Storage. In the east, there's a door that has the label Cell B. In the north you can hear chatter and harsh voices and tones, probably the guard room.

>w
Storage
Very dusty and dark. Someone really needs to clean the cobwebs and dust off the floor and the corners. You look to the left to see a shelf.

>x shelf
Just a regular shelf. Nothing seems unordinary about it, except for the few chips and cracks in the old wood.

You pat your hand on top of the shelf and notice a bump that seems to have made a high pitched tinging sound. It sounds like a key.

>take key
(Brass key)
Taken.

>e
hallway
A hallway that has a couple bits and pieces of wrappers and trash around. You would think in the year 4003 they would take more care of the place. There are foor door ways that lead into seperate rooms. In the west, there's a door that is labeled Storage. In the east, there's a door that has the label Cell B. In the north you can hear chatter and harsh voices and tones, probably the guard room.

>open hallway door with key
Which do you mean, Brass key or Wire key?

>open hallway door with brass key
You unlock Hallway door.

>n
You can't go that way.

* * *

>bend wire
Using your strength and rough hands, you bend the wire into a key!

>bend wire
You attempt to bend the wire into something useful, however your hand slips. You get a small cut on your hand and start bleeding. It doesn't look too bad though, maybe you should try again.
Your health is: 98

>bend wire
You attempt to bend the wire into something useful, however your hand slips. You get a small cut on your hand and start bleeding. It doesn't look too bad though, maybe you should try again.
Your health is: 93

>bend wire
Using your strength and rough hands, you bend the wire into a key!

* * *

>n
hallway
A hallway that has a couple bits and pieces of wrappers and trash around. You would think in the year 4003 they would take more care of the place. There are foor door ways that lead into seperate rooms. In the west, there's a door that is labeled Storage. In the east, there's a door that has the label Cell B. In the north you can hear chatter and harsh voices and tones, probably the guard room.

>s
Cell A
A prison cell that is concealed. The walls and the floor are made of some type of concrete. On the left side of the room is my makeshift of a bed. I need to stop looking around and figure out if I can find a way to get out of this cage. There is a door to the north of the room, the door says Cell A.

>n
hallway
A hallway that has a couple bits and pieces of wrappers and trash around. You would think in the year 4003 they would take more care of the place. There are foor door ways that lead into seperate rooms. In the west, there's a door that is labeled Storage. In the east, there's a door that has the label Cell B. In the north you can hear chatter and harsh voices and tones, probably the guard room.

* * *

>bend wire
Using your strength and rough hands, you bend the wire into a key!

>n
I can't go this way, it's locked! I would need to make a makeshift key in order to unlock this door.

>open door with key
You can't see any such thing.

>n
I can't go this way, it's locked! I would need to make a makeshift key in order to unlock this door.

>w
You can't go that way.

>x shelf
You can't see any such thing.

>take key
You can't see any such thing.

>x shelf
You can't see any such thing.

>e
You can't go that way.

>open hallway door with brass key
You can't see any such thing.

* * *

>x bed
A messy non-made bed. The bed frame is made of some box springs and some metal wire. With my tactical skills maybe I could use some of these things.

>take wire
Taken.

* * *

>e
Cell B
A cell room that looks like it hasn't been used in over 400 years. In the corner there is a broken down bed frame. In the back of the room you spot something that has been collecting dust, it looks like a plaque. You can also see something that looks very high-tech, you can tell it wasn't installed recently, but it looks high-tech. Kind of some sort of voice application.

>1113213211
That's not a verb I recognise.

>'1113213211'
That's not a verb I recognise.

>climb bed
You can't see any such thing.

>climb bed
You can't see any such thing.

* * *

>x box springs
Just some ordinary box springs.

* * *

>bend wire
You cannot bend something that you do not have!

>take wire
Taken.

>bend wire
You attempt to bend the wire into something useful, however your hand slips. You get a small cut on your hand and start bleeding. It doesn't look too bad though, maybe you should try again.
Your health is: 98

>open sturdy with key
You unlock Sturdy metal door.

>w
You can't go that way.

>n
hallway
A hallway that has a couple bits and pieces of wrappers and trash around. You would think in the year 4003 they would take more care of the place. There are foor door ways that lead into seperate rooms. In the west, there's a door that is labeled Storage. In the east, there's a door that has the label Cell B. In the north you can hear chatter and harsh voices and tones, probably the guard room.

>e
Cell B
A cell room that looks like it hasn't been used in over 400 years. In the corner there is a broken down bed frame.

>s
You can't go that way.

>go through door
You can't see any such thing.

>enter door
You can't see any such thing.

>open door
You can't see any such thing.

>n
You can't go that way.

>i
You are carrying:
  Wire key

* * *

>open door with key
You can't see any such thing.

>enter
You must supply a noun.

>n
You can't go that way.

>open door
You can't see any such thing.

>enter hallway
You can't see any such thing.

>n
You can't go that way.

* * *

>bend wire
You attempt to bend the wire into something useful, however your hand slips. You get a small cut on your hand and start bleeding. It doesn't look too bad though, maybe you should try again.
Your health is: 98

>bend wire
Using your strength and rough hands, you bend the wire into a key!

* * *

>n
I can't go this way, it's locked! I would need to make a makeshift key in order to unlock this door.

>open door with key
You unlock Sturdy metal door.

* * *

>n
hallway
A hallway that has a couple bits and pieces of wrappers and trash around. You would think in the year 4003 they would take more care of the place. There are foor door ways that lead into seperate rooms. In the west, there's a door that is labeled Storage. In the east, there's a door that has the label Cell B. In the north you can hear chatter and harsh voices and tones, probably the guard room.

>e
Cell B
A cell room that looks like it hasn't been used in over 400 years. In the corner there is a broken down bed frame. In the back of the room you spot something that has been collecting dust, it looks like a plaque. You can also see something that looks very high-tech, you can tell it wasn't installed recently, but it looks high-tech. Kind of some sort of voice application.

You can see Voice Activation here.

>n
You can't go that way.

>n
You can't go that way.

>x plaque
A very shiny, bright, wooden square that looks like it has been polished, but never touched. On the plaque there are some numbers, I wonder what this could be. I wonder if it's some type of riddle. Under the last number, it looks like someone scratched out the number. I wonder what that number is... It says,

1
11
21
1211
111221
312211
13112221
------

Hmm.. I bet that the voice activation device goes along with the last line of the plaque.

>answer 1113213211
(to Voice Activation)
The wall begins to push outwards, you first think you're going to get crushed. However, it seems to shift into different shapes leaving behind an opening that looks like a secret passage.

>n
Supply closet
A dirty, cramped, and dark supply closet. There's some high-tech looking cleaning supplies in the corner. There is also some clothes with the label "Janitor". That would definitely come in handy.

>s
Cell B
A cell room that looks like it hasn't been used in over 400 years. In the corner there is a broken down bed frame. In the back of the room you spot something that has been collecting dust, it looks like a plaque. You can also see something that looks very high-tech, you can tell it wasn't installed recently, but it looks high-tech. Kind of some sort of voice application.

You can see Voice Activation here.

>x voice activation
Just a small box that seems to have a purpose in this room. It startles you and says "Say "answer" and then put in the code, this will unl…" The sound must be bugged, the last sentence got cut short.

* * *

>take metal wire
I only understood you as far as wanting to take Sturdy metal door.

>take sturdy metal door
That's fixed in place.

>x bed
A messy non-made bed. The bed frame is made of some box springs and some metal wire. With my tactical skills maybe I could use some of these things.

* * *

>open door with key
You unlock Sturdy metal door.

>n
Hallway
A hallway that has a couple bits and pieces of wrappers and trash around. You would think in the year 4003 they would take more care of the place. There are foor door ways that lead into seperate rooms. In the west, there's a door that is labeled Storage. In the east, there's a door that has the label Cell B. In the north you can hear chatter and harsh voices and tones, probably the guard room.

>w
Storage
Very dusty and dark. Someone really needs to clean the cobwebs and dust off the floor and the corners. You look to the left to see a shelf.

* * *

>x shelf
Just a regular shelf. Nothing seems unordinary about it, except for the few chips and cracks in the old wood.

You pat your hand on top of the shelf and notice a bump that seems to have made a high pitched tinging sound. It sounds like a key.

>x shelf
Just a regular shelf. Nothing seems unordinary about it, except for the few chips and cracks in the old wood. There is also a brass key on top.

On Shelf is Brass key.

>take key
(Brass key)
Taken.

>x shelf
Just a regular shelf. Nothing seems unordinary about it, except for the few chips and cracks in the old wood. There was a brass key here.

>e
Hallway
A hallway that has a couple bits and pieces of wrappers and trash around. You would think in the year 4003 they would take more care of the place. There are foor door ways that lead into seperate rooms. In the west, there's a door that is labeled Storage. In the east, there's a door that has the label Cell B. In the north you can hear chatter and harsh voices and tones, probably the guard room.

>open door with brass key
Which do you mean, Hallway door or Sturdy metal door?

>open hallway door with brass key
You unlock Hallway door.

>n
Guard room
A larger room that has a center table and some lockers. This is probably where most of the guards hang out.

You can see Guard Jeffery here.

>attack jeffery
Violence isn't the answer to this one.

* * *

>n
I can't go this way, it's locked! I would need to make a makeshift key in order to unlock this door.

* * *

>take box springs
I don't think I would really need that right now.